"client_ip","client_port","server_ip","server_port","packets","bytes","packets_cli_to_srv","bytes_cli_to_srv","packets_srv_to_cli","bytes_srv_to_cli","start_time","duration","bits/s_cli_to_srv","bits/s_srv_to_cli"
"192.168.11.9",59224,"13.94.40.40",443,117,10491,78,6513,39,3978,0,2092.2669,24.903132578353173,15.210296544862416
"192.168.11.9",57624,"52.114.36.22",443,388,55849,118,17682,270,38167,0.635524,2124.135323,66.59462721999091,143.74602064842176
"192.168.11.9",56526,"3.20.29.163",443,457,36316,167,14758,290,21558,3.065136,2134.589298,55.3099371905499,80.79493332117325
"192.168.11.9",62154,"35.244.0.250",443,133,11455,64,6637,69,4818,3.119504,2098.322478,25.304022883369218,18.368959206278873
"192.168.11.9",55853,"172.217.31.174",443,3130,2670587,944,152624,2186,2517963,4.764201,2130.154103,573.1942108227839,9456.453864831019
"192.168.11.9",56760,"40.90.189.152",443,146,18452,97,7394,49,11058,4.972654,2115.1219039999996,27.966236786700126,41.82453967910873
"192.168.11.9",63770,"52.114.7.78",443,194,25222,122,11342,72,13880,6.359265,2100.499314,43.19734807587754,52.86362116850469
"192.168.11.9",56499,"52.170.57.27",443,26,12838,13,5533,13,7305,6.788874,124.684191,355.00892009637374,468.7041679566257
"192.168.11.9",54812,"108.177.125.189",443,367,80117,155,15398,212,64719,6.933892,2102.69,58.584004299254765,246.23315847794967
"192.168.11.9",62052,"23.48.228.191",443,535,60776,321,30816,214,29960,9.755703,2120.056258,116.28370665624101,113.05360369356764
"192.168.11.9",56085,"172.217.25.78",443,46,5427,19,1859,27,3568,11.853312,300.459952,49.49744517033005,95.00101364590513
"192.168.11.9",55836,"216.58.197.234",443,7,447,3,163,4,284,12.134535,14.972761000000002,87.09148566520228,151.74222042280644
"192.168.11.9",49568,"133.78.99.20",993,44,2649,22,1209,22,1440,14.215214,2055.201809,4.706107185019512,5.60528895486195
"192.168.11.9",56520,"13.35.55.180",443,250,94159,117,13368,133,80791,14.663163,543.1680279999999,196.88935004841636,1189.9227618014368
"192.168.11.9",56522,"3.235.72.190",443,43,16911,20,3812,23,13099,14.663879,180.901492,168.57793522233638,579.2765932521994
"192.168.11.9",56524,"13.226.77.31",443,65,12919,31,3086,34,9833,15.47789,542.3546699999999,45.520028434529756,145.04162008967307
"192.168.11.9",56528,"104.18.70.113",443,43,6845,20,2153,23,4692,15.616211,400.060819,43.053453829978785,93.82573403170481
"192.168.11.9",56596,"64.233.188.188",443,99,9119,49,2691,50,6428,15.71334,2117.4790070000004,10.166806815478381,24.285482798177274
"192.168.11.9",56529,"13.226.77.101",443,65,12465,30,3000,35,9465,15.727191,542.51058,44.238768578485605,139.5733148651221
"192.168.11.9",56531,"104.18.71.113",443,43,6800,20,2136,23,4664,15.792292,400.055872,42.71403370377225,93.26697246928549
"192.168.11.9",56533,"3.80.20.234",443,22,7434,10,2016,12,5418,15.998892,110.744997,145.63186091377113,391.3856262057599
"192.168.11.9",56534,"143.204.122.37",443,65,12857,29,3076,36,9781,16.228506,542.0739169999999,45.39602299293069,144.34931758577864
"192.168.11.9",55882,"143.204.121.190",443,33,2928,15,1083,18,1845,16.952826,328.015543,26.41338249023157,44.99786767726431
"192.168.11.9",56537,"104.16.53.111",443,104,20217,45,8050,59,12167,17.174177,702.913168,91.61871328038629,138.47514092949814
"192.168.11.9",56540,"13.114.185.55",443,143,18585,68,5497,75,13088,17.719337,2118.351244,20.759541234985107,49.427119462158466
"192.168.11.9",56545,"3.235.72.190",443,45,25340,23,9199,22,16141,20.339022,334.39315,220.07627847639822,386.15623555685875
"192.168.11.9",56546,"3.235.72.190",443,36,17883,19,5899,17,11984,20.339436,334.394267,141.12682141168406,286.7034798775423
"192.168.11.9",56547,"3.235.72.254",443,22,8510,11,2828,11,5682,20.427559,91.238665,247.96504858987143,498.2098324213753
"192.168.11.9",56554,"3.235.71.135",443,26,12559,14,4964,12,7595,23.131604,16.872403000000002,2353.6659241721522,3601.1467957468767
"192.168.11.9",56173,"216.58.220.142",443,221,50148,96,29358,125,20790,23.813986,765.780398,306.69889254595415,217.19020287589026
"192.168.11.9",60457,"52.114.6.61",443,235,26338,127,16004,108,10334,27.865483,2085.105008,61.403142531802885,39.64884247211016
"192.168.11.9",52171,"40.74.219.49",443,154,87289,77,73447,77,13842,35.341851,2072.437547,283.5192794352514,53.432731982827754
"192.168.11.9",56585,"3.235.71.135",443,29,17663,14,3109,15,14554,35.731102,4.262839,5834.609282686961,27313.252975305895
"192.168.11.9",55667,"172.217.26.35",443,13,810,6,328,7,482,38.658207,149.991899,17.494278140981468,25.708055073027644
"192.168.11.9",56610,"3.235.72.190",443,35,23922,15,3211,20,20711,47.32286,64.94579100000001,395.52986582302145,2551.173793541139
"192.168.11.9",56614,"3.235.71.135",443,55,40125,23,5787,32,34338,48.636334,306.076393,151.25635644824135,897.5014286711096
"192.168.11.9",56615,"18.205.93.224",443,221,23214,145,11719,76,11495,48.659117,2067.271275,45.35060353895741,44.48376036183253
"192.168.11.9",56564,"40.90.189.152",443,105,15328,70,7383,35,7945,49.267244,2040.138529,28.95097522076159,31.154747139232132
"192.168.11.9",56618,"18.205.93.209",443,427,74594,230,37802,197,36792,49.526057,2075.260088,145.72438498128145,141.8308971015107
"192.168.11.9",56619,"3.235.71.135",443,31,19133,13,4308,18,14825,49.565761,147.82940499999998,233.13359070883092,802.2761100878408
"192.168.11.9",56622,"18.177.216.52",443,25,7893,12,2246,13,5647,50.58323,0.0806129999999996,222892.08936523995,560405.8898688825
"192.168.11.9",56623,"18.163.141.56",443,13,5541,5,799,8,4742,50.594075,0.11186000000000007,57142.85714285711,339138.2084748791
"192.168.11.9",56624,"18.180.23.126",443,20,7604,11,2192,9,5412,50.594391,0.06079199999999929,288459.00776418287,712198.9735491595
"192.168.11.9",56625,"18.163.203.101",443,11,5441,5,799,6,4642,50.59463,0.16355899999999934,39080.6987081116,227049.56621158205
"192.168.11.9",56629,"52.68.4.56",443,14728,1627806,6051,817249,8677,810557,50.698597,2087.914254,3131.350814562714,3105.7099148478733
"192.168.11.9",56630,"18.205.93.247",443,21,9392,11,3282,10,6110,50.818326,303.906185,86.39508274568351,160.8391089506783
"192.168.11.9",56631,"18.205.93.247",443,21,8704,11,3243,10,5461,50.818648,303.908704,85.36774254415563,143.75369782104036
"192.168.11.9",56632,"52.202.62.222",443,21,8473,11,3047,10,5426,50.818874,303.901704,80.21014584373637,142.83565846672582
"192.168.11.9",56633,"18.205.93.247",443,21,8748,11,3274,10,5474,50.819077,303.909844,86.18345380085812,144.09536533472735
"192.168.11.9",56639,"3.235.72.254",443,19,7611,10,2029,9,5582,53.659835,143.56188400000002,113.06622306516957,311.0574948988549
"192.168.11.9",56665,"20.189.73.166",443,28,9918,15,3458,13,6460,64.205714,0.32384700000000066,85423.05471410864,159581.53078459858
"192.168.11.9",56681,"172.217.24.142",443,38,5762,19,2697,19,3065,69.799525,240.06478999999996,89.87573729575254,102.13909336725308
"192.168.11.9",63833,"133.78.99.20",993,42,2528,21,1154,21,1374,86.389342,1983.028526,4.655505394378779,5.54303675205931
"192.168.11.9",57123,"18.205.93.255",443,22,8924,12,3135,10,5789,197.256244,1657.26495,15.133367781657363,27.94483766762822
"192.168.11.9",57160,"52.202.62.236",443,141,90060,60,24370,81,65690,214.213388,283.434787,687.8478187647447,1854.1125652300402
"192.168.11.9",57161,"216.58.220.109",443,1149,1050915,293,45745,856,1005170,214.849318,251.094974,1457.4564921399024,32025.173072560185
"192.168.11.9",57164,"172.217.161.65",443,146,90150,46,4901,100,85249,215.617909,248.77344800000003,157.60524410949193,2741.4179667598605
"192.168.11.9",57167,"172.217.26.35",443,116,39865,43,7754,73,32111,216.235593,272.528673,227.61641671370114,942.6090736514905
"192.168.11.9",57168,"216.58.197.174",443,64,33469,24,4128,40,29341,216.783269,243.938996,135.37810904165565,962.2405759184153
"192.168.11.9",57171,"172.217.31.174",443,44,6299,20,3346,24,2953,217.472946,243.549519,109.90783356874542,96.99875449148392
"192.168.11.9",57183,"172.217.26.46",443,50,6862,23,3401,27,3461,222.788403,289.38038299999994,94.02157712950434,95.68029357401191
"192.168.11.9",57184,"13.35.55.153",443,44,9818,21,2452,23,7366,222.884086,240.03052799999998,81.7229381755974,245.50210546551816
"192.168.11.9",57187,"31.13.82.7",443,28,5481,12,1659,16,3822,223.2535,65.03363599999997,204.07900920686652,470.15670475505954
"192.168.11.9",57188,"31.13.82.36",443,27,5148,13,2322,14,2826,223.339754,65.04224500000001,285.59899800506577,347.5894781922118
"192.168.11.9",57189,"172.217.26.10",443,85,14050,35,4830,50,9220,223.584487,302.9854230000001,127.5308878473668,243.44405506267535
"192.168.11.9",57190,"216.58.197.234",443,63,7377,27,3350,36,4027,223.60371,288.16995,93.00067546945823,111.79514033298754
"192.168.11.9",57236,"13.107.42.23",443,52,35854,20,2955,32,32899,244.725689,121.07245799999998,195.25497698246122,2173.8387437380684
"192.168.11.9",57265,"52.159.49.199",443,25,13155,12,4228,13,8927,256.038684,125.81443100000001,268.84038445478484,567.6296386064012
"192.168.11.9",57268,"40.74.219.49",443,25,12941,12,4252,13,8689,256.687886,125.47585300000003,271.09598529686815,553.9870687310648
"192.168.11.9",57288,"74.125.171.235",443,24,8268,12,1802,12,6466,265.611852,139.367997,103.43838119450048,371.16125016850174
"192.168.11.9",57289,"74.125.171.235",443,24,8274,12,1808,12,6466,265.612272,139.36830099999997,103.78256674019441,371.16044056531916
"192.168.11.9",57290,"172.217.175.118",443,102,56921,37,3980,65,52941,265.640183,250.72337700000003,126.99254605205799,1689.2242162165835
"192.168.11.9",57291,"172.217.25.227",443,14,2232,8,1092,6,1140,265.968721,68.728702,127.10846772575452,132.69565312029317
"192.168.11.9",57296,"172.217.25.66",443,105,24148,46,17602,59,6546,268.074623,313.640095,448.9732092448193,166.96844834203995
"192.168.11.9",57299,"74.125.171.235",443,25,11632,12,3623,13,8009,268.731397,136.24816499999997,212.72947052167643,470.25954441294687
"192.168.11.9",57300,"74.125.171.235",443,38,21097,19,8663,19,12434,268.731823,136.24884199999997,508.65753413155625,730.0759297462508
"192.168.11.9",57303,"52.13.236.243",443,34,12083,17,4820,17,7263,269.610804,60.53092000000004,637.0298022894741,959.9061107942844
"192.168.11.9",57305,"216.58.197.129",443,50,14217,22,2737,28,11480,269.670356,242.68502399999994,90.22394393813111,378.4329106356395
"192.168.11.9",57306,"74.125.170.107",443,719,741220,214,29041,505,712179,269.714735,6.708177999999975,34633.547291082745,849326.29992824
"192.168.11.9",57307,"74.125.170.107",443,498,490752,162,21370,336,469382,269.715229,6.70879199999996,25482.9781576178,559721.630958304
"192.168.11.9",57312,"172.217.25.227",443,207,178795,65,5608,142,173187,271.252269,289.12754,155.1702753739751,4791.989030169869
"192.168.11.9",57313,"172.217.26.46",443,113,107965,31,2852,82,105113,271.262757,0.5156939999999963,44243.29156437764,1630625.9138171203
"192.168.11.9",57314,"172.217.25.227",443,75,49013,30,2961,45,46052,271.435138,240.029431,98.68789798530999,1534.8784458019234
"192.168.11.9",57315,"172.217.27.78",443,20,9355,8,2063,12,7292,271.823792,0.31106499999998505,53056.43515021231,187536.3669972604
"192.168.11.9",57316,"172.217.175.67",443,39,5503,18,2789,21,2714,272.093521,240.09475899999995,92.92997520199933,90.43096188534463
"192.168.11.9",57317,"172.217.25.196",443,223,96801,81,15001,142,81800,272.09458,288.20650700000004,416.3958726997097,2270.594119514449
"192.168.11.9",57321,"172.217.175.118",443,119,120648,31,2143,88,118505,272.697308,60.38641999999999,283.90489119904777,15699.55629096741
"192.168.11.9",57324,"74.125.170.107",443,35,17168,16,6197,19,10971,274.118734,130.963126,378.5493024960324,670.1733738395952
"192.168.11.9",57327,"172.217.31.170",443,38,5012,18,2411,20,2601,274.337199,240.23670099999998,80.2874828022218,86.61457601351262
"192.168.11.9",57328,"172.217.161.70",443,31,4257,16,2231,15,2026,274.347625,240.03937499999995,74.354467886779,67.5222554632964
"192.168.11.9",57329,"172.217.31.170",443,38,6119,18,3081,20,3038,274.568043,240.32081000000005,102.56290331245137,101.13148337008349
"192.168.11.9",57332,"52.114.158.91",443,29,13244,15,5458,14,7786,275.208072,138.249164,315.83554458238893,450.5488365918798
"192.168.11.9",57342,"172.217.25.196",443,38,5576,17,2290,21,3286,279.657705,240.09504699999997,76.30311507425641,109.48997211091991
"192.168.11.9",57349,"133.78.99.40",443,18,7634,9,2962,9,4672,281.431989,0.09849500000001399,240580.7401390592,379471.0391389887
"192.168.11.9",57350,"133.78.99.40",443,34,24325,13,3130,21,21195,281.432664,0.6683869999999956,37463.32588754743,253685.36491583634
"192.168.11.9",57351,"172.217.161.78",443,84,9454,37,4433,47,5021,281.472996,249.04308499999996,142.401062852237,161.2893608348933
"192.168.11.9",57353,"133.78.99.40",443,139,133773,44,4473,95,129300,281.629046,0.6957229999999868,51434.26334906375,1486798.6253149884
"192.168.11.9",57354,"133.78.99.40",443,19,10127,8,2481,11,7646,282.187994,0.09504600000002483,208825.20042921128,643562.0646843005
"192.168.11.9",57355,"133.78.99.40",443,14,3927,7,2427,7,1500,282.189547,0.0675200000000018,287559.2417061535,177725.11848340757
"192.168.11.9",57356,"133.78.99.40",443,102,101588,29,3607,73,97981,282.191942,0.17603500000001304,163921.94734000546,4452796.318913522
"192.168.11.9",57357,"133.78.99.40",443,17,6862,8,2465,9,4397,282.192941,0.09307699999999386,211867.59349787058,377923.65460857487
"192.168.11.9",57361,"133.78.99.40",443,51,42813,17,2951,34,39862,282.397551,0.07747299999999768,304725.51727699593,4116221.1351052565
"192.168.11.9",57362,"133.78.99.40",443,27,16628,11,2723,16,13905,282.983369,0.14633600000001934,148862.8908812399,760168.3796194054
"192.168.11.9",57367,"133.78.99.40",443,60,50551,19,3219,41,47332,284.514208,0.8513040000000274,30250.06343209849,444795.2787723162
"192.168.11.9",57368,"133.78.99.40",443,19,4538,9,2908,10,1630,284.514974,0.14556800000002568,159815.34403162712,89580.12750053377
"192.168.11.9",57369,"133.78.99.40",443,17,3913,8,2561,9,1352,284.893403,0.9873550000000364,20750.38866466392,10954.519904188059
"192.168.11.9",57373,"133.78.99.40",443,15,3885,8,2593,7,1292,286.192916,0.07729399999999487,268377.8818537193,133723.18679329168
"192.168.11.9",57374,"133.78.99.40",443,16,3763,8,2593,8,1170,286.194613,0.11683699999997543,177546.4964010062,80111.6084802072
"192.168.11.9",57376,"133.78.99.40",443,16,3683,8,2513,8,1170,286.209253,0.051341000000036274,391577.88122525456,182310.43415580894
"192.168.11.9",57379,"172.217.161.74",443,40,8248,18,2400,22,5848,286.610008,240.10332600000004,79.9655728217609,194.84944577569073
"192.168.11.9",57386,"133.78.99.40",443,247,258412,69,6039,178,252373,290.261451,0.5002029999999991,96584.78657665006,4036329.250324376
"192.168.11.9",57388,"133.78.99.40",443,16,3971,8,2673,8,1298,290.261924,0.08196499999996831,260891.84407989102,126688.2205820047
"192.168.11.9",57391,"133.78.99.40",443,17,3945,8,2593,9,1352,290.458153,0.3174380000000383,65348.19397802877,34072.79531750671
"192.168.11.9",57394,"133.78.99.40",443,16,3971,8,2609,8,1362,291.427453,0.07125500000000784,292919.7951020659,152915.5848712203
"192.168.11.9",57395,"133.78.99.40",443,16,3795,8,2625,8,1170,291.440925,0.09971100000001343,210608.65902455267,93871.28802237206
"192.168.11.9",57396,"133.78.99.40",443,15,3661,8,2545,7,1116,291.454199,0.07342499999998608,277289.75144710735,121593.46271708126
"192.168.11.9",57397,"133.78.99.40",443,19,7210,9,2647,10,4563,291.847201,0.09788200000002689,216342.12623356882,372938.8447313088
"192.168.11.9",57398,"133.78.99.40",443,16,3763,8,2577,8,1186,291.847981,0.08916399999998248,231214.39145848158,106410.65901038384
"192.168.11.9",57416,"133.78.99.40",443,16,4131,8,2785,8,1346,299.12721,0.10918800000001738,204051.72729600736,98618.89584934503
"192.168.11.9",57417,"133.78.99.40",443,17,5070,9,2839,8,2231,299.266646,0.06011300000000119,377821.7690017059,296907.49089214724
"192.168.11.9",57420,"133.78.99.40",443,15,4205,8,2801,7,1404,299.391166,0.07290299999999661,307367.32370411424,154067.73383812082
"192.168.11.9",57421,"133.78.99.40",443,22,11073,10,2909,12,8164,299.392211,0.1204490000000078,193210.40440351097,542237.7935889527
"192.168.11.9",57422,"133.78.99.40",443,28,18042,11,2963,17,15079,299.393899,0.12085300000001098,196139.11115154647,998171.3321141307
"192.168.11.9",57423,"133.78.99.40",443,18,6868,9,3063,9,3805,299.902892,0.09775700000000143,250662.35665987746,311384.35099276324
"192.168.11.9",57424,"133.78.99.40",443,22,11105,10,2925,12,8180,299.904824,0.10977399999995896,213165.23038250176,596133.8750526032
"192.168.11.9",57432,"133.78.99.40",443,36,25322,16,9446,20,15876,303.115189,0.587333000000001,128662.95610837442,216245.29866361976
"192.168.11.9",57436,"133.78.99.40",443,22,11121,10,2861,12,8260,303.757362,0.08655099999998583,264445.24037854845,763480.4912711675
"192.168.11.9",57437,"133.78.99.40",443,18,7476,9,3015,9,4461,303.758117,0.07049999999998136,342127.65957455855,506212.7659575807
"192.168.11.9",57480,"133.78.99.40",443,18,5252,9,2679,9,2573,321.859402,0.09072300000002542,236235.57422036302,226888.44063792238
"192.168.11.9",57481,"133.78.99.40",443,16,3763,8,2577,8,1186,321.863337,0.08033199999999852,256634.96489568765,118109.844146793
"192.168.11.9",57510,"133.78.99.40",443,37,26208,16,10166,21,16042,334.693159,0.3167100000000005,256790.12345678973,405216.12831928197
"192.168.11.9",57511,"133.78.99.40",443,19,7706,9,3015,10,4691,335.036898,0.11983900000001313,201270.03730002217,313153.48092020035
"192.168.11.9",57513,"133.78.99.40",443,23,11175,10,2861,13,8314,335.037414,0.13735099999996692,166638.757635587,484248.38552333816
"192.168.11.9",57523,"133.78.99.40",443,23,11394,13,10004,10,1390,338.372793,0.3626310000000217,220698.1752800925,30664.780451752154
"192.168.11.9",57524,"133.78.99.40",443,17,3945,8,2593,9,1352,338.804813,0.7447429999999713,27853.90396418738,14523.130798141663
"192.168.11.9",57525,"133.78.99.40",443,234,254893,56,5297,178,249596,338.805659,0.6238569999999868,67925.82274463683,3200682.207621366
"192.168.11.9",57528,"133.78.99.40",443,16,3971,8,2609,8,1362,339.73001,0.07522699999998395,277453.5738498738,144841.61271886856
"192.168.11.9",57529,"133.78.99.40",443,16,3795,8,2625,8,1170,339.731912,0.10186499999997523,206155.20541898697,91886.32012960562
"192.168.11.9",57530,"133.78.99.40",443,15,3661,8,2545,7,1116,339.735334,0.06069800000000214,335431.1509440061,147088.8661899846
"192.168.11.9",57531,"133.78.99.40",443,16,3763,8,2577,8,1186,339.986198,0.5737369999999942,35932.84030836465,16537.193871059557
"192.168.11.9",57532,"133.78.99.40",443,19,7210,9,2647,10,4563,339.98714,0.598735999999974,35367.84158627663,60968.44018064988
"192.168.11.9",57553,"172.217.31.170",443,35,7386,17,2749,18,4637,348.474773,240.021522,91.62511685097972,154.55280714368607
"192.168.11.9",57566,"52.202.62.233",443,19,8732,9,2974,10,5758,354.834985,65.91513599999996,360.94896322447113,698.8379725105934
"192.168.11.9",57587,"3.12.230.238",443,29,12089,12,3281,17,8808,364.164972,60.978183,430.4490345342038,1155.5608339461344
"192.168.11.9",57598,"172.217.27.67",443,46,6486,23,3002,23,3484,368.888084,240.10933500000004,100.02110080393166,116.0804514326775
"192.168.11.9",57679,"143.204.121.27",443,33,3555,16,1901,17,1654,405.002064,240.03691400000002,63.356921844112684,55.12485467131109
"192.168.11.9",57723,"172.217.25.78",443,66,13256,31,6545,35,6711,423.795523,411.48002499999996,127.24797515991209,130.47534931981207
"192.168.11.9",57796,"13.88.28.53",443,20,8002,12,3120,8,4882,456.29798,0.9171660000000088,27214.266555890383,42583.349142902836
"192.168.11.9",57799,"20.190.141.194",443,25,12580,13,3587,12,8993,457.004817,1.0802170000000046,26565.03276656438,66601.43286024909
"192.168.11.9",57802,"52.109.112.35",443,21,11408,10,2068,11,9340,458.08907,110.09783100000004,150.26635720007957,678.6691374510364
"192.168.11.9",57803,"20.190.141.226",443,68,62762,25,5782,43,56980,458.123347,108.55295599999994,426.11460529918713,4199.24078345688
"192.168.11.9",57804,"20.190.141.226",443,21,10863,12,4609,9,6254,458.16267,0.10973300000000563,336015.60150545515,455943.06179542554
"192.168.11.9",57809,"52.109.44.29",443,37,28139,21,17366,16,10773,460.227331,0.41716000000002396,333032.8890593346,206596.98916481697
"192.168.11.9",57813,"69.192.132.150",443,49,21835,20,1971,29,19864,461.255232,44.90357,351.15248074930344,3538.9613787946037
"192.168.11.9",57825,"117.18.237.29",80,8,1487,5,514,3,973,466.552704,0.4305800000000204,9549.909424496738,18077.941381391684
"192.168.11.9",57951,"52.109.12.23",443,72,32620,36,13536,36,19084,522.523805,149.6980259999999,723.3762721760944,1019.8664877518164
"192.168.11.9",57956,"37.218.245.50",443,40,12849,18,2675,22,10174,524.913822,117.66894300000001,181.86617007344068,691.703332458761
"192.168.11.9",57968,"23.35.196.86",443,23,8990,12,1284,11,7706,529.535628,500.08527600000014,20.54049677719365,123.27497520642856
"192.168.11.9",58012,"52.109.12.20",443,25,17337,10,2151,15,15186,548.147275,121.03539599999999,142.17328623438388,1003.7394350327073
"192.168.11.9",58013,"172.217.26.35",443,36,4662,17,2168,19,2494,548.715563,240.06588699999998,72.24683280386273,83.11051707234023
"192.168.11.9",58014,"52.114.159.32",443,26,12838,13,5533,13,7305,548.806342,127.90383100000008,346.0725113073429,456.9057825953623
"192.168.11.9",58018,"216.58.220.142",443,70,15390,31,8853,39,6537,549.130569,241.54757299999994,293.2093215442906,216.50393481701434
"192.168.11.9",58330,"3.12.112.141",443,27,11914,12,3156,15,8758,690.306554,61.013765000000035,413.8082611358271,1148.3310364472666
"192.168.11.9",58346,"172.217.25.67",443,35,4338,17,2062,18,2276,697.931167,240.12826800000005,68.69661842561575,75.82614138540322
"192.168.11.9",58347,"172.217.31.131",443,77,19389,37,12022,40,7367,697.945337,265.255543,362.5786624937749,222.18574335315589
"192.168.11.9",58348,"172.217.175.16",443,56,13492,24,2398,32,11094,698.155479,99.33115799999996,193.13174623414747,893.4960770315397
"192.168.11.9",58349,"69.192.132.251",443,29,15353,14,1838,15,13515,698.272258,120.89592200000004,121.62527698825106,894.3229698020746
"192.168.11.9",58354,"52.113.194.132",443,40,32572,12,1893,28,30679,698.493212,63.37651800000003,238.9528563244827,3872.6015209608054
"192.168.11.9",58357,"52.139.168.125",443,22,6563,12,1998,10,4565,699.805813,0.3064510000000382,52158.42010630739,119170.76465730392
"192.168.11.9",58359,"13.94.40.236",443,32,10012,15,2552,17,7460,700.057443,121.32043999999996,168.28161849726234,491.9204051683296
"192.168.11.9",58362,"52.114.74.43",443,16,7661,8,2439,8,5222,700.365898,123.81419099999994,157.59098244239232,337.408819317004
"192.168.11.9",58363,"216.58.220.142",443,60,21056,32,17956,28,3100,700.982126,240.14385800000002,598.1747823839825,103.27143157665101
"192.168.11.9",58372,"143.204.121.37",443,32,3500,15,1847,17,1653,705.072611,240.02671799999996,61.559813520426516,55.09386667529238
"192.168.11.9",58397,"172.217.175.14",80,30,8991,16,2611,14,6380,715.012464,82.47408199999995,253.26744467431612,618.861086565353
"192.168.11.9",58398,"13.107.42.23",443,58,41825,19,2482,39,39343,715.086364,126.18266700000004,157.35917200101653,2494.3520967107147
"192.168.11.9",58399,"173.194.49.7",80,39,23023,18,3457,21,19566,715.09067,82.396076,335.64705192999725,1899.7021168823624
"192.168.11.9",58402,"52.114.32.24",443,17,7972,9,3090,8,4882,715.595592,0.088867999999934,278165.36886188906,439483.2785707904
"192.168.11.9",58526,"52.114.74.44",443,30,17719,16,9900,14,7819,772.793703,6.465196999999989,12250.206760907693,9675.18855187245
"192.168.11.9",58527,"52.114.74.44",443,18,7760,9,1109,9,6651,773.016496,73.00298200000009,121.52928218740419,728.8469394305007
"192.168.11.9",58568,"52.139.168.125",443,22,6410,12,1842,10,4568,789.003558,0.3208479999999554,45928.29003142313,113898.16984991361
"192.168.11.9",58571,"52.139.168.125",443,22,6093,12,1525,10,4568,789.97705,0.343654000000015,35500.82350270757,106339.51590843814
"192.168.11.9",58572,"52.139.168.125",443,22,5886,12,1333,10,4553,790.311515,0.2997689999999693,35574.05869186304,121506.89364144969
"192.168.11.9",58575,"52.114.32.24",443,18,8139,10,3256,8,4883,791.271912,0.047031999999944674,553835.686341866,830583.4325575343
"192.168.11.9",58578,"52.139.168.125",443,23,6603,12,1908,11,4695,791.605869,0.37459499999999935,40748.00784847642,100268.28975293334
"192.168.11.9",58579,"52.139.168.125",443,22,5906,12,1345,10,4561,791.984113,0.30137999999999465,35702.43546353504,121069.74583582404
"192.168.11.9",58580,"52.139.168.125",443,22,6540,12,1971,10,4569,792.308746,0.32881299999996827,47954.30837589001,111163.48806161413
"192.168.11.9",58584,"52.139.168.125",443,23,8579,12,1870,11,6709,792.722291,0.3073739999999816,48670.34947653639,174614.63884389444
"192.168.11.9",58585,"52.139.168.125",443,22,5925,12,1365,10,4560,793.056745,0.32292100000006485,33816.3204003388,112968.80661212084
"192.168.11.9",58594,"172.217.161.46",443,40,6034,19,2885,21,3149,796.778439,240.13289399999996,96.11344624864265,104.90857616532954
"192.168.11.9",58786,"216.58.220.130",443,50,7183,22,2863,28,4320,813.7804619999999,255.03465900000015,89.80740143244604,135.5109934293283
"192.168.11.9",58858,"52.113.194.132",443,49,18677,22,9889,27,8788,845.805118,162.93180300000006,485.5528420071554,431.4934144563537
"192.168.11.9",58866,"172.217.26.35",443,35,4608,16,2114,19,2494,848.753511,240.0727760000001,70.44530530192226,83.10813217738604
"192.168.11.9",58933,"20.190.141.194",443,26,12727,14,3721,12,9006,879.006173,0.4997409999999718,59566.85563122034,144170.68041246178
"192.168.11.9",58934,"20.190.141.226",443,77,74580,29,16092,48,58488,879.518595,124.10139000000004,1037.3453512486844,3770.3364966339204
"192.168.11.9",58936,"20.190.141.226",443,21,11055,12,4777,9,6278,879.521296,0.13722699999993893,278487.469667172,365992.1152544496
"192.168.11.9",58958,"161.69.45.107",443,63,24980,29,10656,34,14324,888.53009,63.20359000000008,1348.7841434323573,1813.0615681799065
"192.168.11.9",59003,"172.217.31.131",443,29,8174,15,2853,14,5321,908.747191,0.5150559999999587,44313.6280326835,82647.32378615804
"192.168.11.9",59037,"69.192.133.104",80,10,1046,6,551,4,495,924.521593,60.19441399999994,73.22938636797768,65.78683530335563
"192.168.11.9",59038,"184.27.173.220",80,13,5514,6,549,7,4965,924.521698,60.15900799999997,73.00652297990024,660.2502488072945
"192.168.11.9",59039,"23.67.73.114",443,23,9946,10,1067,13,8879,924.598922,60.12157000000002,141.9789935625433,1181.4728058498802
"192.168.11.9",59140,"133.130.87.212",80,88,91357,25,1732,63,89625,967.655051,0.06978600000002189,198549.85240586443,10274267.044962816
"192.168.11.9",59346,"138.91.140.216",443,36,18026,19,10066,17,7960,986.78739,212.75797699999998,378.49579665819067,299.30722644538025
"192.168.11.9",59387,"143.204.121.27",443,38,8849,17,2030,21,6819,1005.154105,240.03362300000015,67.65718817650804,227.2681606776396
"192.168.11.9",59399,"13.107.42.12",443,31,13501,13,2292,18,11209,1009.497909,125.83180499999992,145.71832614178913,712.6338209962105
"192.168.11.9",59430,"172.217.25.78",443,66,12797,31,6323,35,6474,1023.781022,412.486681,122.6318383841344,125.5604177920111
"192.168.11.9",59519,"52.242.231.33",443,615,515250,220,112029,395,403221,1065.027951,6.060680999999931,147876.45150767878,532245.138788865
"192.168.11.9",59524,"124.40.41.75",80,392,345897,147,16902,245,328995,1066.212389,3.976693999999952,34002.11331321988,661846.2471590802
"192.168.11.9",59527,"52.114.77.34",443,18,8278,10,3396,8,4882,1066.363854,1.13465599999995,23943.82085848151,34421.00513283473
"192.168.11.9",59539,"191.232.139.2",443,45,19798,25,14026,20,5772,1071.313543,8.297716000000037,13522.757346720411,5564.904848514916
"192.168.11.9",59540,"13.59.223.245",443,28,10241,13,3335,15,6906,1072.169491,60.84964499999978,438.45777571915323,907.9428483107863
"192.168.11.9",59543,"216.58.197.162",443,73,16168,33,11543,40,4625,1072.248815,246.57296700000006,374.5098301875079,150.0570011796954
"192.168.11.9",59545,"52.114.77.34",443,22,10457,12,5467,10,4990,1072.556906,1.4547720000000481,30063.817560413972,27440.72610690794
"192.168.11.9",59564,"52.229.175.79",443,21,4848,12,1264,9,3584,1080.088171,0.32698899999991227,30924.58767726961,87684.90683175181
"192.168.11.9",59567,"104.118.90.105",443,20,9042,9,1164,11,7878,1080.387364,0.08360600000014529,111379.56605965861,753821.4960635657
"192.168.11.9",59568,"104.118.90.105",443,20,8530,9,1421,11,7109,1080.639384,0.08037999999987733,141428.21597433876,707539.1888540284
"192.168.11.9",59570,"117.18.232.240",80,1019,1105610,296,17188,723,1088422,1080.758472,30.052897999999914,4575.39901809138,289734.98662258877
"192.168.11.9",59571,"117.18.232.240",80,778,778685,271,16745,507,761940,1080.793602,30.017553000000134,4462.722194577266,203065.18655934322
"192.168.11.9",59572,"52.114.77.34",443,23,11856,13,6509,10,5347,1081.126785,1.4831520000000182,35109.011079106764,28841.278574279288
"192.168.11.9",59578,"52.114.77.34",443,20,9027,11,4091,9,4936,1083.153843,1.1308289999999488,28941.599481443685,34919.51479843706
"192.168.11.9",59599,"216.58.220.142",443,58,14892,26,5018,32,9874,1091.665826,251.13345700000013,159.85126187308438,314.54192103125456
"192.168.11.9",59606,"52.114.77.34",443,18,8535,10,3653,8,4882,1094.389361,1.1876680000000306,24606.203080321477,32884.61085084299
"192.168.11.9",59613,"172.217.31.174",443,117,18168,53,8566,64,9602,1096.789097,488.077994,140.4037896451443,157.38468225223858
"192.168.11.9",59883,"172.217.26.35",443,36,4663,17,2169,19,2494,1148.712546,240.06081199999994,72.28168502570925,83.11227406828901
"192.168.11.9",59974,"172.217.24.138",443,28,7389,14,1631,14,5758,1190.208375,30.233494000000064,431.57433275823075,1523.6082207369052
"192.168.11.9",59975,"52.139.153.205",443,24,8291,13,1502,11,6789,1190.326046,30.11566800000014,398.9949683334251,1803.4466311688568
"192.168.11.9",59978,"64.233.189.108",993,133,109227,47,3340,86,105887,1190.497529,29.94451099999992,892.317126167132,28288.857346844045
"192.168.11.9",59982,"74.125.203.109",465,22,4817,10,900,12,3917,1191.512439,0.9163639999999305,7857.139739230858,34196.01817618586
"192.168.11.9",60231,"143.204.121.5",443,34,3575,17,1955,17,1620,1305.218707,240.02704900000003,65.1593229394742,53.99391466084307
"192.168.11.9",60703,"172.217.26.14",443,39,6993,18,2855,21,4138,1448.614486,240.25847700000008,95.06428362150982,137.78494067453857
"192.168.11.9",60704,"172.217.26.35",443,71,7439,31,3249,40,4190,1448.662399,540.293097,48.10722206950573,62.04040026815297
"192.168.11.9",60745,"172.217.25.202",443,42,11058,19,3333,23,7725,1467.800536,240.28524199999993,110.9681134724038,257.19432240453625
"192.168.11.9",60835,"172.217.161.65",443,39,8806,18,2229,21,6577,1504.999235,240.07846100000006,74.27571772046637,219.16168481269958
"192.168.11.9",60886,"216.58.220.142",443,85,12546,37,5941,48,6605,1528.051938,463.169361,102.61473232466255,114.08353930388759
"192.168.11.9",60887,"172.217.31.131",443,71,21053,34,14099,37,6954,1528.054131,241.54663499999992,466.9574469542912,230.31577318392374
"192.168.11.9",60888,"172.217.161.65",443,135,108273,48,4044,87,104229,1528.236517,240.82451500000002,134.33848294057603,3462.404979825247
"192.168.11.9",60892,"216.58.197.174",443,36,5059,17,2548,19,2511,1529.25475,240.21436799999992,84.85753857987382,83.62530587679088
"192.168.11.9",60920,"172.217.24.142",443,37,5988,18,2923,19,3065,1541.88868,240.06588199999987,97.40659441144582,102.13862876191634
"192.168.11.9",61050,"52.139.153.205",443,22,6568,12,2000,10,4568,1600.259545,0.3300400000000536,48478.97224578051,110725.9726093627
"192.168.11.9",61061,"143.204.121.27",443,33,3556,15,1847,18,1709,1605.279419,240.02649799999995,61.55986994402594,56.960377766291465
"192.168.11.9",61099,"168.62.57.154",443,40,24509,23,18424,17,6085,1621.185679,1.1553040000001147,127578.5420979979,42136.09578084657
"192.168.11.9",61107,"172.217.25.78",443,66,12890,31,6330,35,6560,1623.787761,413.55805699999996,122.44955488800936,126.89874882548838
"192.168.11.9",61261,"99.84.194.193",443,19,7687,9,934,10,6753,1691.903815,1.1349310000000514,6583.660152026565,47601.131698753095
"192.168.11.9",61274,"99.84.194.229",443,19,6760,9,999,10,5761,1698.076264,1.4050869999998667,5687.904023025449,32800.81589254215
"192.168.11.9",61277,"99.84.194.229",443,21,10420,10,1005,11,9415,1698.767106,0.7144599999999173,11253.254205975045,105422.2769644329
"192.168.11.9",61387,"216.58.220.142",443,69,15461,30,8837,39,6624,1749.927001,241.78533599999992,292.39159483187194,219.16961912032588
"192.168.11.9",61461,"168.63.154.101",443,22,12008,11,2791,11,9217,1782.325849,0.306583000000046,72828.56518462097,240509.09541621333
"192.168.11.9",61764,"23.67.72.40",80,10,1113,6,617,4,496,1842.515149,60.099911999999904,82.12990395060825,66.02339118233661
"192.168.11.9",61765,"104.18.21.226",80,10,1199,6,547,4,652,1842.580232,60.02443799999992,72.9036396808914,86.89793980245192
"192.168.11.9",61792,"3.235.72.255",443,19,8468,9,2832,10,5636,1854.554187,65.74328700000001,344.6131313756794,685.8190707744807
"192.168.11.9",61897,"168.63.154.101",443,23,12382,12,2979,11,9403,1902.051643,0.31329200000004676,76069.60918247655,240108.26960148607
"192.168.11.9",61900,"168.63.154.101",443,19,9240,10,1348,9,7892,1902.307852,0.2943150000000969,36641.01387967466,214518.45811453447
"192.168.11.9",61907,"143.204.121.37",443,25,3015,13,1739,12,1276,1905.339964,225.11381800000004,61.799849176739556,45.34595028724535
"192.168.11.9",62026,"52.113.194.132",443,25,3952,12,2376,13,1576,1957.802789,125.7439109999998,151.16437725561144,100.26728053655036
"192.168.11.9",62123,"216.58.220.142",443,32,7360,15,3332,17,4028,1998.344313,135.2872910000001,197.03255052982013,238.18940982416433
"192.168.11.9",62237,"172.217.26.35",443,22,3798,10,1786,12,2012,2048.708264,45.07869900000014,316.9567959359243,357.06443080799534
"192.168.11.9",62255,"40.74.219.49",443,21,11475,11,4181,10,7294,2057.27596,45.74661100000003,731.1579867632157,1275.5480400504414
"192.168.11.9",62407,"13.59.223.76",443,21,11596,10,3142,11,8454,2127.138778,0.729577000000063,34452.84048153633,92700.29071639341
"192.168.11.9",62418,"3.21.213.80",443,22,11449,10,2956,12,8493,2132.045174,0.7297060000000783,32407.57236475712,93111.47229157045
